-1700,0,0,0,0,0,0,0,0,0,0,0,1,0,0,0,0,-700
-350,-400,-450,-500,-550,-600,-650,-700,-750,-800,-850,-900,-950,-300,-1000,-1700,-1650,-250,14,0,2,2,0,0,0,0,0,0,0,0,0,0,0,0,1000
-1650,-1000,-950,-900,-850,-800,-750,-700,-650,-600,-550,-500,-450,-400,-350,-300,-1600,-1550,-1500,-1450,-1400,-1350,-1300,-1250,-1200,-1150,-1100,-1050,-1700,-250,16,12,1,1,0,0,0,0,0,0,0,0,0,0,0,0,1050
-850,-900,-950,700,650,600,550,100,50,150,200,250,300,350,400,450,500,-1000,-1700,0,-1650,750,-800,3,14,3,3,0,0,0,0,0,0,0,0,0,0,0,0,500
-300,-350,-400,-450,-500,-550,-600,-650,-700,-750,-800,-850,-900,-950,-1000,-1700,-1650,-250,14,0,2,2,0,0,0,0,0,0,0,0,0,0,0,0,950
-300,-350,-400,-450,-500,-550,-600,-650,-700,-750,-800,-850,-900,-950,-1000,-1700,-1650,-250,14,0,2,2,0,0,0,0,0,0,0,0,0,0,0,0,900
-300,-350,-400,-450,-500,-550,-600,-650,-700,-750,-800,-850,-900,-950,-1000,-1700,-1650,-250,14,0,2,2,0,0,0,0,0,0,0,0,0,0,0,0,850
-950,-900,-850,-1000,-1700,-1650,-800,3,0,2,2,0,0,0,0,0,0,0,0,0,0,0,0,650
-900,-950,-850,-1000,-1700,-1650,-800,3,0,2,2,0,0,0,0,0,0,0,0,0,0,0,0,600
-850,-900,-950,-1000,-1700,-1650,-800,0,750,3,0,2,2,0,0,0,0,2,0,0,0,0,0,0,0,450
-850,-900,-950,-1000,-1700,-1650,-800,0,750,3,0,2,2,0,0,0,0,0,0,0,2,0,0,0,0,400
-850,-900,-950,-1000,-1700,-1650,-800,3,0,2,1,0,0,1,0,0,0,0,0,0,0,0,0,350
-900,-950,-1000,-1700,-1650,-850,2,0,2,2,0,0,0,0,0,0,0,0,0,0,0,0,300
-950,-900,-1000,-1700,-1650,-850,2,0,2,1,0,0,1,0,0,0,0,0,0,0,0,0,250
-950,-1000,-1700,-1650,-900,1,0,2,2,0,0,0,0,0,0,0,0,0,0,0,0,200
-950,-1000,-1700,-1650,-900,1,0,2,1,0,0,1,0,0,0,0,0,0,0,0,0,150
-1000,-1700,-1650,-950,0,0,2,1,0,0,1,0,0,0,0,0,0,0,0,0,100
-1700,-1650,-1000,0,0,1,1,0,0,0,0,1,0,0,0,0,0,0,0,50
-1700,-1650,-1000,0,0,1,1,0,0,0,0,1,0,0,0,0,0,0,0,0
-1700,-1650,-1000,0,0,1,1,0,0,0,0,1,0,0,0,0,0,0,0,-50
-1700,-1650,-1050,-1100,-1000,-1150,0,0,1,1,2,0,1,0,0,1,0,0,0,0,0,0,-100
-1100,-1150,-1700,-1650,-1050,1,0,2,2,0,0,0,0,0,0,0,0,0,0,0,0,-150
-1100,-1150,-1700,-1650,-1050,0,1,2,1,0,0,1,0,0,0,0,0,0,0,0,0,-200
-1700,-1650,-1150,0,0,1,1,0,0,0,0,1,0,0,0,0,0,0,0,-250
-1700,-1650,-1150,0,0,1,1,0,0,0,0,1,0,0,0,0,0,0,0,-300
-1700,-1650,-1150,0,0,1,1,0,0,0,0,1,0,0,0,0,0,0,0,-350
-1700,-1650,-1150,0,0,1,1,0,0,0,0,1,0,0,0,0,0,0,0,-400
-1700,-1650,-1150,0,0,1,1,0,0,0,0,1,0,0,0,0,0,0,0,-450
-1700,-1650,-1150,0,0,1,1,0,0,0,0,1,0,0,0,0,0,0,0,-500
-1700,-1650,-1150,0,0,1,1,0,0,0,0,1,0,0,0,0,0,0,0,-550
-1650,-1700,-1150,-1200,-1250,-1300,-1350,-1400,-1450,-1500,-1550,-1600,1,0,1,1,9,0,0,0,0,0,0,0,0,0,0,0,-600
-1650,-1200,-1250,-1300,-1350,-1400,-1450,-1500,-1550,-1600,-1700,-1150,0,10,1,0,0,0,1,0,0,0,0,0,0,0,0,0,-650
3300,3250,3200,3150,2200,2250,2900,2850,2800,2750,2700,2650,2600,2550,2500,2450,2400,2350,2300,2150,2100,2050,2000,1950,1900,1850,1800,1750,1700,1650,1600,1550,3650,3600,3550,3500,3450,3400,3350,1500,2950,3100,3700,0,0,0,0,32,0,0,7,0,1,1,0,1,1,0,0,1750
3250,3200,2900,2850,2800,2750,2700,2650,2600,2550,2500,2450,2400,2350,2300,2250,2200,2150,2100,2050,2000,1950,1900,1850,1800,1750,1700,1650,1600,1550,1500,3300,2950,3150,30,0,1,2,0,1,0,0,0,0,0,0,0,0,0,0,1700
3250,2900,2850,2800,2750,2700,2650,2600,2550,2500,2450,2400,2350,2300,2250,2200,2150,2100,2050,2000,1950,1900,1850,1800,1750,1700,1650,1600,1550,1500,3300,2950,3200,29,0,1,2,0,1,0,0,0,0,0,0,0,0,0,0,1650
2900,2850,2800,2750,2400,2350,2300,2250,2200,2150,2100,2050,2000,1950,1900,1850,1800,1750,1700,1650,1600,1550,2700,2650,2600,2550,2500,2450,1500,3300,2950,3250,22,6,1,2,0,1,0,0,0,0,0,0,0,0,0,0,1600
2100,2050,2000,1950,1900,1850,1800,1750,1700,1650,1600,1550,1500,2150,12,0,1,1,0,0,0,0,0,0,0,0,0,0,0,0,1400
2250,2200,2150,2100,2050,2000,1950,1900,1850,1800,1750,1700,1650,1600,1550,2900,1500,3350,2850,3400,2300,2950,15,1,1,0,0,2,3,0,0,0,0,0,0,0,0,0,1500
2900,2850,2300,2250,2200,2150,2100,2050,2000,1950,1900,1850,1800,1750,1700,1650,1600,1550,2800,2350,1500,2950,3350,3300,2750,2400,3400,18,2,1,1,1,2,1,0,0,0,1,0,0,0,0,0,1550
2150,2100,2050,2000,1950,1900,1850,1800,1750,1700,1650,1600,1550,2200,1500,2250,13,1,1,0,0,0,1,0,0,0,0,0,0,0,0,0,1450
2100,2050,2000,1950,1900,1850,1800,1750,1700,1650,1600,1550,2100,2050,2000,1950,1900,1850,1800,1750,1700,1650,1600,1550,1500,1500,2150,2150,0,24,0,0,0,2,2,0,0,0,0,0,0,0,0,0,1350
2350,2400,2300,2250,2450,0,0,0,0,0,0,0,3,0,0,0,0,1,1,0,0,1150
-1650,-300,-350,-400,-450,-500,-550,-600,-650,-700,-750,-800,-850,-900,-950,-1000,-1050,-1100,-1150,-1200,-1250,-1300,-1350,-1400,-1450,-1500,-1550,-1600,1550,1650,1600,1500,1450,-1700,-250,2150,1400,2200,1700,0,0,0,0,28,0,0,5,0,1,1,0,2,2,0,0,1100
-950,-900,-850,-800,-750,-700,-650,-600,-550,-300,-350,-400,-450,-500,-1000,-1700,-1650,-250,1700,1650,1600,1550,1500,1450,1400,1350,1300,1250,1200,1150,1100,1050,1000,1750,14,0,2,2,14,0,0,0,0,1,1,0,0,0,0,0,800
-750,-700,-900,-950,-850,-800,1700,1650,1600,1550,1500,1450,1400,1350,1300,1250,1200,1150,1100,1050,-300,-350,-400,-450,-500,-550,-600,-650,-1000,-1700,1000,-1650,1750,-250,20,8,3,2,0,0,1,0,0,0,0,0,0,0,0,0,750
-950,-900,-850,-800,-750,1700,1650,1600,1550,1500,1450,1400,1350,1300,1250,1200,1150,1100,1050,-1000,-1700,-1650,1000,-700,1750,4,15,2,1,0,1,2,0,0,0,0,0,0,0,0,0,700
-900,-950,-850,-1000,-1700,-1650,-800,700,650,600,550,500,450,400,350,300,250,200,150,100,50,0,750,3,0,2,2,14,0,0,0,0,1,1,0,0,0,0,0,550
750,400,3,-450,750,3,2550,1600,3,2200,1100,3,1550,1100,3,1350,700,3,-800,600,3,-1700,-700,3,2150,1350,3,3300,1650,3,0,400,3,1
-650,750,450,50,1,520,10,20,1,-1650,-650,550,50,0,0,10,10,1,1250,700,250,50,1,450,10,10,1,2150,1100,100,50,0,0,10,10,1,1400,1100,350,50,1,370,10,10,1,2450,1600,300,50,0,0,10,10,1,1
